NO ./resources/cub3d_wall_north.png
SO ./resources/cub3d_wall_south.png
EA ./resources/cub3d_wall_east.png
WE ./resources/cub3d_wall_west.png
F 141,141,63
C 141,120,63

        1111111111111111111111111
        1000000000110000000000001
        1011000001110000000000001
        1001000000000000000000001
111111111011000001110000000000001
100000000011001001110111111111111
11110111111111 111 1000010001
11110111111111 111 1010010001
11000000110101111110000010001
10000000000000000000000000001
10001000000000001101010010001
11000001110101011111011110S0111
11110111 1010101 101111010001
11111111 1111111 111111111111