NO ./resources/north.png
SO ./resources/south.png
EA ./resources/east.png
WE ./resources/west.png
C 242,79,209
F 218,159,23

  1111                1111
 110011              110011
1100001111111111111111000011
1100000000000000000000000011
 11000000000N00000000000011
1100000000000000000000000011
1100001111111111111111000011
 110011              110011
  1111                1111