NO ./resources/north.png
SO ./resources/south.png
EA ./resources/east.png
WE ./resources/west.png
C 225,30,0
F 255,100,0

1111111111111111111111111
1000000000000000000000011
1000100000000000100000101
1001000011100000100001001
1010000000000000100010001
110000000000W000000100001
1000000000000000000000001
1111111111111111111111111
