NO ./resources/north.png
SO ./resources/south.png
EA ./resources/east.png
WE ./resources/west.png
C 225,30,0
F 255,100,0



                  111
                  101
                  101
                  101
                  101
                  101
                  101
                  101
                  101
                  101
                  101
                  101
                  101
                  101
                  101
                  101
                  101
                  101
                  101
                  101
                  101
                  101
                  101
111111111111111111101111111111111111111111111
1000000000000000000N0000000000000000000000001
111111111111111111101111111111111111111111111
                  101
                  101
                  101
                  101
                  101
                  101
                  101
                  101
                  101
                  101
                  101
                  101
                  101
                  101
                  101
                  101
                  101
                  101
                  101
                  101
                  101
                  101
                  111
