NO ./resources/north.png
SO ./resources/south.png
EA ./resources/east.png
WE ./resources/west.png
C 225,30,0
F 255,100,0

        1111111111111111111111111
        1000000000110000000000001
        1011000001110000000000001
        1001000000000000000000001
111111111011000001110000000000001
100000000011000001110111111111111
111101111111110111 1000010001
111101111111110111 1010010001
11000000110101011110000010001
10000000000000001100000000001
10000000000000001101010010001
11000001110101011111011110N0111
11110111 1010101 101111010001
11111111 1111111 111111111111