NO ./resources/north.png
SO ./resources/south.png
EA ./resources/east.png
WE ./resources/west.png
C 225,30,0
F 255,100,0

   11111111111111111111111
  1110000000000000000000111
  1110000000000000000000111
 111000000001111100000000111
110000000011     110000000011
1100000001         1000000011
110000000011     110000000011
 11100000000111110000N000111
  1110000000000000000000111
  1110000000000000000000111
   11111111111111111111111