NO ./resources/ryanair.png
SO ./resources/bryan.png
EA ./resources/rayman.png
WE ./resources/rayan.png
C 225,30,0
F 255,100,0

       1
      101
     10001
    1001001
   1001 1001
  10000100001
 100000S000001
111111111111111