NO ./resources/ryanair.png
SO ./resources/bryan.png
EA ./resources/rayman.png
WE ./resources/rayan.png
C 150,150,150
F 50,50,50

       1
      101
     10001
    1000001
   10000 001
  10000000001
 100S000000001
111111111111111